the = [dhu, dhi]
I = Ai
to = tú
a = u
and = and
of = of
was = wus
in = in
my = mai
it = it
with = with
me = mi
at = at
for = for
had = had
that = dhat
on = on
as = as
up = áp
were = wer
he = hi
one = wán
they = dhei
but = bát
then = dhen
this = dhis
is = is
there = dher
be = bi
by = bai
an = an
time = taim
some = sám
am = am
which = wic
around = uraund
after = áftur
we = wy
out = aut
from = from
people = pipul
when = wen
them = dhem
not = not
about = ubaut
before = bifor
she = shi
like = laik
go = gou
have = hav
their = dher
what = wát
who = hoú
said = sed
more = mor
got = got
game = geim
also = olsou
event = ivent
later = leitur
his = his
you = yú
going = gouiŋ
so = sou
get = get
no = nou
him = him
back = bak
guy = gai
would = wúd
another = unádhur
other = ádhur
eventually = ivencúuli
free = fry
into = intú
still = stil
just = jást
myself = maiself
suits = soúts
didn't = didunt
girl = gurl
her = hur
asked = áskd
group = grúp
last = lást
members = memburs
down = daun
while = wail
again = ugen
are = ar
could = kúd
week = wyk
large = larj
went = went
school = skúl
very = veri
decided = disaidud
if = if
our = aur
see = si
society = sousaiuti
arrived = uraivd
inside = insaid
where = wer
do = dú
dream = drym
outside = autsaid
something = sámthiŋ
next = nekst
soon = sún
all = ol
day = dei
been = byn
how = hau
playing = pleiiŋ
few = fiú
same = seim
well = wel
long = loŋ
night = nait
now = nau
only = onli
place = pleis
started = startud
find = faind
left = left
told = tould
however = háwevur
member = membur
room = rúm
Chinese = Cainyz
us = ás
end = end
first = furst
since = sins
building = bildiŋ
can = kan
events = ivents
having = haviŋ
home = houm
name = neim
off = of
pizza = pitsá
high = hai
reason = ryzun
called = kold
than = dhan
white = wait
David = Deivid
house = haus
saw = soo
suddenly = sádunli
too = toú
afterwards = áfturwurds
did = did
door = dor
woke = wouk
bit = bit
blue = bloú
doing = dúiŋ
little = litul
look = lúk
looking = lúkiŋ
made = meid
open = oupun
or = or
play = plei
say = sei
bus = bás
until = ántil
wake = weik
big = big
good = gúd
line = lain
came = keim
chat = cat
I'm = Aim
its = its
most = moust
over = ouvur
real = ryl
toilet = toilut
family = famuli
found = faund
old = ould
talk = took
through = thrú
wanted = wántud
wasn't = wuzunt
way = wei
being = byŋ
Danny = Danny
turned = turnd
initially = inishuli
lot = lot
thought = thoot
chatting = catiŋ
different = difrunt
know = nou
played = pleid
year = yiur
any = ani
side = said
small = smol
Timothy = Timuthy
took = túk
although = oldhou
Asian = Eishun
once = wáns
sit = sit
student = stúdunt
team = tym
walk = wook
asking = áskiŋ
card = kard
computer = kompiútur
each = yc
earlier = urliur
food = fúd
friends = frends
life = laif
make = meik
probably = probubli
studying = stádiiŋ
tech = tek
things = thiŋs
though = dhou
will = wil
because = bikoz
boardgames = bourdgeims
car = kar
decide = disaid
enough = ináf
even = ivun
finished = finishd
including = iŋklúdiŋ
prominent = prominunt
scooter = skútur
start = start
these = dhyz
whether = wedhur
ask = ásk
front = fránt
getting = getiŋ
minutes = minits
much = mác
own = oun
really = ryli
trivia = triviá
world = wurld
became = bikeim
dreams = dryms
full = fúl
here = hiur
join = join
past = pást
right = rait
running = rániŋ
semester = semestur
Singapore = Siŋupor
somewhere = sámwer
without = withaut
work = wurk
already = olredi
august = ogust
come = kám
due = diú
ended = endud
girls = gurls
hi = hai
Kosta = Kostá
may = mei
point = point
ready = redi
realise = rylaiz
saying = seiiŋ
shortly = shortli
stuff = stáf
almost = olmoust
began = bigan
many = meni
pretty = priti
sleep = slyp
workshop = wurkshop
your = yor
eating = ytiŋ
games = geims
hall = hol
joined = joind
leave = lyv
looked = lúkd
met = met
person = pursun
take = teik
train = trein
away = uwei
bye = bai
instead = insted
interesting = intrustiŋ
meet = myt
new = niú
ones = wáns
Papa = Pápá
problem = problum
security = sikiuriti
sitting = sitiŋ
talking = tookiŋ
try = trai
used = yúsd
waiting = weitiŋ
whom = hoúm
board = bourd
early = urli
entered = enturd
experience = ekspiriuns
feel = fyl
felt = felt
ground = graund
lunch = lánc
near = niur
park = park
part = part
previous = privius
seen = syn
social = soushul
someone = sámwán
surprise = surpraiz
together = túgedhur
towards = touwurds
volunteering = voluntiuriŋ
why = wai
access = akses
boardroom = bourdrúm
Deanna = Dyanná
has = has
head = hed
knew = niú
leaving = lyviŋ
man = man
monster = monstur
similar = similur
slime = slaim
station = steishun
study = stádi
thing = thiŋ
Vo = Vo
ago = ugou
anyway = aniwei
continue = kontiniú
execs = ekseks
face = feis
hand = hand
hours = auurs
info = infou
lab = lab
mouth = mauth
never = nevur
nothing = náthiŋ
particular = partikiúlur
return = riturn
sausage = sosij
watch = woc
wide = waid
attendees = utendis
ball = bol
better = betur
city = siti
class = klás
clear = kliur
conversation = konvurseishun
eat = yt
every = evri
everyone = evriwán
handball = handbol
happened = hapund
help = help
mall = mol
noticed = noutisd
quite = kwait
september = septembur
slices = slaisus
slightly = slaitli
talked = tookd
tell = tel
trying = traiiŋ
tuesday = cúsdei
using = yúsiŋ
volunteer = voluntiur
walking = wookiŋ
want = wánt
window = windou
young = yáŋ
apparently = uparuntli
appears = epiurs
area = eriu
Chloe = Kloui
Colin = Kolin
forgot = forgot
friend = frend
gave = geiv
Indonesian = Indoneishun
it's = its
late = leit
Maddie = Maddi
Microsoft = Maikrosoft
paper = peipur
phone = foun
plane = plein
programming = prougramiŋ
run = rán
scared = skerd
shopping = shopiŋ
stopped = stopd
table = teibul
tall = tol
today = túdei
top = top
video = vidiou
years = yiurs
campus = kampus
empty = emti
explained = ekspleind
floor = flor
form = form
give = giv
laptop = laptop
level = levul
living = liviŋ
main = mein
might = mait
mind = maind
needed = nydud
returned = riturnd
science = saiuns
sign = sain
strange = streinj
think = thiŋk
total = toutul
tutorial = tiútoriul
version = vurzhun
voice = vois
walked = wookd
cute = kyút
dark = dark
days = deis
drinks = driŋks
during = dúriŋ
entrance = entruns
Facebook = Feisbúk
international = inturnashunul
job = job
Justin = Jástin
moved = múvd
mum = mám
occurred = okurd
Peter = Pytur
places = pleisus
program = prougram
shirt = shurt
spoke = spouk
strangely = streinjli
students = stúdynts
Sydney = Sidny
system = sistum
they're = dheir
weeks = wyks
weird = wiurd
writing = raitiŋ
apartment = upartmunt
Ben = Ben
boys = bois
Casula = Kasula
chatted = catud
despite = dispait
discord = diskord
don't = dont
done = dán
encountered = eŋkaunturd
english = iŋglish
except = eksept
glass = glás
greet = gryt
guys = gais
held = held
move = múv
need = nyd
october = oktoubur
others = adhurs
position = pozishun
put = pút
realised = rylaizd
representative = reprizentutiv
sausages = sosijus
scary = skeri
Scott = Skott
signed = saind
sleeping = slypiŋ
studies = stadis
tried = traid
wall = wol
water = wotur
yet = yet
amongst = umoŋst
anyone = aniwán
appeared = epiurd
boy = boi
clique = klyk
club = kláb
corner = kornur
cyber = saibur
does = dás
extremely = ekstrymli
formed = formd
gate = geit
half = hálf
idea = aidiu
Indian = Indiun
interested = intrustud
Jane = Jein
Jeremy = Jerumy
Josh = Josh
kept = kept
least = lyst
let = let
light = lait
lights = laits
Maggie = Maggy
managed = manijd
meeting = mytiŋ
message = mesij
middle = midul
nice = nais
online = onlain
possible = posibul
says = seis
seeing = siiŋ
seemed = symd
spot = spot
suggested = sujestud
teams = tyms
those = dhouz
under = ándur
university = yúnivursiti
unlike = ánlaik
use = yús
wait = weit
write = rait
able = eibul
accent = aksent
asks = ásks
ate = eit
attend = utend
attending = utendiŋ
bad = bad
based = beisd
behind = bihaind
best = best
both = bouth
bread = bred
break = breik
bright = brait
carrying = káriiŋ
condominium = kondominium
cool = kúl
doors = dors
fear = fiur
Gary = Gary
hard = hard
heading = hediŋ
heard = hurd
highway = haiwei
hour = auur
I'll = Ail
I've = Aiv
immediately = imidiutli
Julia = Júliá
kid = kid
lecture = lekcur
led = led
less = les
march = marc
nearby = niurbai
nighttime = naittaim
observe = obzurv
office = ofis
overall = ouvurol
parents = parunts
particularly = partikiúlurli
pool = púl
preparing = priperiŋ
problems = problums
project = projekt
raining = reiniŋ
recognised = rekunaizd
remember = rimembur
reminded = rimaindud
rest = rest
rules = rúls
sat = sat
set = set
Singaporean = Siŋguporiun
sister = sistur
sky = skai
slept = slept
sometimes = sámtaims
somewhat = sámwát
store = stour
stream = strym
sure = shur
taking = teikiŋ
times = taims
toilets = toiluts
town = taun
turn = turn
watching = wociŋ
Western = Westurn
wheel = wyl
Aayush = Ááyúsh
above = ubáv
alarm = ularm
alone = uloun
along = uloŋ
Andrew = Androú
assignments = usainmunts
Atlassian = Atlassiun
attended = utendud
bed = bed
black = blak
challenge = calunj
check = cek
children = cildrun
classmates = klasmeits
comp = komp
couldn't = kúdunt
coupons = koúpons
driving = draiviŋ
enter = entor
feeling = fyliŋ
Fengjin = Fengjin
final = fainul
finishing = finishiŋ
football = fútbol
fun = fán
Korean = Kouriun
land = land
lemonade = lemuneid
live = [laiv, liv]
located = loukeitud
longer = loŋgur
love = láv
mentioned = menshund
Michael = Maikul
passed = pásd
pieces = pysus
positions = pozishuns
present = [presunt, prisent]
presumably = prizhúmubli
public = páblik
recently = risuntli
representatives = reprizentutivs
required = rikwaiurd
sandwiches = sandwicus
setting = setiŋ
short = short
showing = shouiŋ
sort = sort
speaking = spykiŋ
spotted = spotud
stall = stol
story = stori
such = sác
theatre = thiutur
Thursday = Thursdei
unusual = unyúzhúul
various = verius
volunteers = voluntiurs
Wednesday = Wenusdei
welcome = welkám
whole = houl
win = win
woman = wúmun
advanced = advánsd
airport = erport
announced = enaunsd
brother = brádhur
buy = bai
cashier = kashiur
chess = ces
Commbank = Kommbaŋk
confused = konfiúsd
couple = kápul
dude = dúd
everything = evrithiŋ
familiar = familiur
field = fyld
fire = faiur
forgotten = forgotun
giving = giviŋ
grabbed = grabd
interestingly = intrustiŋli
kind = kaind
known = noun
learn = lurn
liked = laikd
local = loukul
lock = lok
lost = lost
low = lou
making = meikiŋ
music = miúzik
must = mást
negative = negutiv
note = nout
pay = pei
pop = pop
questions = kwescuns
queue = kiú
quickly = kwikli
remembered = rimemburd
ride = raid
road = roud
robot = roubot
Sandra = Sandrá
should = shúd
show = shou
single = siŋgul
speech = spyc
speed = spyd
sunny = sáni
support = suport
suspicious = suspishus
trip = trip
type = taip
venue = veniú
view = viú
waking = weikiŋ
wearing = weriŋ
won = wán
wonder = wándur
word = wurd
working = wurkiŋ
zoom = zúm
actually = akcúuli
anymore = animor
approached = uproucd
Australian = Ostreiliun
brown = braun
busy = bizi
can't = kant
caught = koot
close = klous
complex = kompleŋ
crashed = krashd
crowded = kraudud
Daniel = Daniul
data = dátá
desk = desk
doesn't = dázunt
eastern = ysturn
easy = yzi
else = els
email = imeil
exactly = eksaktli
executive = eksukiútiv
expected = ekspektud
exploring = eksploriŋ
fact = fakt
finding = faindiŋ
fucking = fákiŋ
gift = gift
grass = grás
great = greit
hacking = hakiŋ
himself = himself
hotel = houtel
invited = invaitud
issues = ishús
keep = kyp
kill = kil
language = laŋgwij
ledge = lej
library = laibruri
linguistics = liŋgwistiks
locked = lokd
looks = lúks
machine = mushyn
membership = memburship
morning = morniŋ
movie = múvi
names = neims
notice = noutis
nowhere = nouwer
number = námbur
onto = ontú
opened = oupund
ourselves = aurselvs
pack = pak
party = parti
pee = py
photos = foutous
players = pleiurs
practice = praktis
presence = prezuns
putting = pútiŋ
ran = ran
realising = rylaiziŋ
red = red
riding = raidiŋ
role = roul
sandwich = sandwic
scheduled = skejúld
serving = surviŋ
sex = seks
software = softwer
somehow = sámhau
speak = spyk
stairs = sters
steep = styp
stop = stop
subject = sábjekt
thank = thaŋk
thinking = thiŋkiŋ
typical = tipikul
Unihack = Yúnihak
usual = yúzhúul
Venus = Vynus
wandering = wonduriŋ
warning = worniŋ
windows = windous
within = widhin
women = wimun
across = ukros
Agastya = Ágástyá
air = er
allowing = ulauiŋ
approaching = uprouciŋ
arranged = ureinjd
available = uveilubul
avoid = uvoid
awesome = oosum
ballroom = bolrúm
bandannas = bandannás
barrier = bariur
become = bikám
belongings = biloŋiŋs
between = bitwyn
block = blok
bowling = bouliŋ
brand = brand
briefly = bryfli
brought = broot
candidates = kandideits
ceiling = syliŋ
certain = surtun
coding = koudiŋ
coming = kámiŋ
company = kámpuni
compared = komperd
competition = komputishun
computers = kompiúturs
concrete = koŋkryt
continued = kontiniúd
covered = kávurd
current = kárunt
dad = dad
Dan = Dan
dancing = dansiŋ
Dang = Dáŋ
decides = disaids
Delicia = Dulishiá
described = diskraibd
dominion = dominiun
dominos = dominous
engineering = enjiniuriŋ
especially = espeshuli
exit = eksit
fast = fást
female = fymeil
filled = fild
film = film
fine = fain
finish = finish
flying = flaiiŋ
general = jenurul
gone = gon
goodbye = gúdbai
guided = gaidud
hash = hash
hidden = hidun
included = iŋklúdud
indeed = indyd
intended = intendud
items = aitums
Jarryd = Jarryd
joining = joiniŋ
Lakepoint = Leikpoint
lazy = leizi
lettuce = letus
lit = lit
location = loukeishun
loudly = laudli
Manning = Manniŋ
maths = maths
metal = metul
mildly = maildli
money = máni
mustard = másturd
mysterious = mistirius
national = nashunul
nightclub = naitkláb
opposite = opuzit
originally = orijinuli
perhaps = purhaps
pissed = pisd
platform = platform
player = pleiur
playground = pleigraund
president = prezidunt
process = proses
read = red
reasons = ryzuns
relatives = relutivs
remaining = rimeiniŋ
remembering = rimemburiŋ
resembling = rizembuliŋ
rocket = roket
showed = shoud
simply = simpli
smaller = smolur
soccer = sokur
sound = saund
starts = starts
staying = steiiŋ
stood = stúd
street = stryt
strongly = stroŋli
theme = thym
themselves = dhemselvs
understand = ándurstand
uni = yúni
urge = urj
via = vaiu
walls = wols
Wong = Woŋ
actual = akcúul
additional = adishunul
age = eij
agreed = ugryd
Alex = Aleks
answer = ánsur
anything = anithiŋ
app = ap
approach = uprouc
Arthur = Arthur
artwork = artwurk
assignment = usainmunt
attendance = utenduns
attention = utenshun
audience = odiuns
backyard = bakyard
bag = bag
bandanna = bandanná
basic = beisik
beat = byt
belonging = biloŋiŋ
besides = bisaids
body = bodi
bottom = botum
browns = brauns
bush = búsh
call = kol
calligraphy = kaligrufi
cash = kash
centre = sentur
chalk = cook
chance = cáns
changed = ceinjd
classmate = klásmeit
closed = klouzd
combination = kombineishun
connection = konekshun
corridors = koridors
counted = kauntud
crash = krash
credit = kredit
culture = kálcur
damn = dam
deal = dyl
deep = dyp
dinner = dinur
direction = dairekshun
drive = draiv
eh = eh
either = ydhur
employee = emploiy
enemy = enemi
entering = enturiŋ
exams = igzáms
fans = fáns
far = far
fashion = fáshun
fee = fy
feelings = fyliŋs
flag = flag
flat = flat
floors = flors
Friday = Fraidei
future = fiúcur
generally = jenuruli
given = givun
grab = grab
green = gryn
groups = grúps
haired = herd
hands = hands
Hangul = Hángúl
heavily = hevili
heavy = hevi
hence = hens
houses = hausus
human = hiúmun
intact = intakt
introduced = introdiúsd
jobs = jobs
Joel = Jouul
kids = kids
knowledge = nolij
Kong = Koŋ
lady = leidi
layout = leiaut
leader = lydur
leading = lydiŋ
lift = lift
loud = laud
lying = laiiŋ
mama = mámá
Mariana = Márianá
market = markit
meaning = myniŋ
meetup = mytáp
mixed = miksd
multiple = máltipul
mural = miúrul
narrow = narou
noise = noiz
non = non
Optiver = Optivur
organiser = orgunaizur
outlet = autlet
packed = pákd
pants = pants
participate = partisipeit
passing = pásiŋ
pick = pik
picked = pikd
pizzas = pitsás
plastic = plástik
Popo = Popo
post = poust
presentation = prezunteishun
primary = praimuri
prior = praiur
privacy = praivusi
raspberry = razberi
Redfern = Redfurn
result = rizolt
rockets = rokits
Samuel = Samiúul
scene = syn
section = sekshun
seems = syms
server = survur
shape = sheip
shaped = sheipd
size = saiz
slice = slais
slow = slou
solder = souldur
song = soŋ
space = speis
special = speshul
staff = staf
stay = stei
tables = teibeus
techniques = teknyks
technology = teknoluji
Teddy = Teddy
tells = tels
terrain = turein
text = tekst
throughout = thrúaut
Tom = Tom
track = trak
Tristan = Tristun
turning = turniŋ
underground = ándurgraund
unfortunately = ánforcunutli
unknown = ánnoun
upcoming = ápkámiŋ
visit = vizit
vitamin = vaitumin
VMware = VMware
waited = weitud
we're = wiur
WiFi = WaiFi
worried = wurid
wrong = roŋ
zone = zoun
activities = aktivitis
afternoon = áfturnún
aged = eijd
airplane = erplein
aisle = ail
always = olweis
Amazon = Amuzon
amount = umaunt
apartments = upartmunts
argument = argiúmunt
Ariel = Ariul
article = artikul
assume = ushúm
attempts = utempts
attitudes = atitiúds
avenue = avuniú
awkward = ookwurd
bachelor = baculur
background = bakgraund
below = bilou
beside = bisaid
bored = bord
bottles = botuls
buildings = bildiŋs
cancer = kansur
candidate = kandideit
capture = kapcur
carried = karid
carry = kari
case = keis
casual = kazhúul
chairs = cers
challenging = calunjiŋ
change = ceinj
channel = canul
character = karaktur
charge = carj
checking = cekiŋ
chicken = cikun
cinema = sinimu
cloud = klaud
coach = kouc
Cody = Koudy
colourful = kálurfúl
community = komiúniti
connect = konekt
connected = konektud
connections = konekshuns
consisting = konsistiŋ
cost = kost
customers = kástumurs
cut = kát
dance = dans
degree = digry
departed = dipartud
design = dizain
Devina = Deviná
Dickinson = Dikinsun
distance = distuns
drawing = drooiŋ
dreamt = dremt
dudes = dúds
easier = yziur
easily = yzili
elected = ilektud
election = ilekshun
elevated = eliveitud
elevator = eliveitur
emerged = imurjd
entire = entaiur
environment = invairunmunt
Eric = Erik
example = eksámpul
experiment = ekspirimunt
explaining = ekspleiniŋ
explains = ekspleins
explanation = ekspluneishun
explore = eksplor
faces = feisus
facing = feisiŋ
falling = foliŋ
favourite = feivrut
finally = fainuli
fit = fit
flashbacks = flashbaks
flight = flait
fly = flai
focused = foukusd
follow = fálou
followed = fáloud
following = fálouiŋ
forced = forsd
freebies = frybis
French = Frenc
friendly = frendli
Gaby = Gaby
garlic = garlik
giant = jaiunt
Glenfield = Glenfyld
Greg = Greg
guess = ges
harder = hardur
headquarters = hedkworturs
hearing = hiuriŋ
height = hait
helped = helpd
herself = hurself
highest = haiust
Hong = Hoŋ
hot = hot
ideas = aidius
imagined = imajind
incident = insidunt
individual = indivijúul
industry = indástri
insult = insált
interaction = inturakshun
interest = intrust
Internet = Inturnet
internship = inturnship
Jakarta = Jákartá
Japanese = Japunyz
Jay = Jei
jumbled = jámbuld
Kmart = Keimart
knowing = nouiŋ
Kung = Kúŋ
lack = lak
larger = larjur
largest = larjust
laughing = láfiŋ
learning = lurniŋ
learnt = lurnt
Lego = Legou
likely = laikli
lined = laind
Linux = Linuks
list = list
locks = loks
logo = lougou
lots = lots
Louise = Loúiz
major = meijur
management = manijmunt
mandarin = mandurin
manner = manur
maximum = maksimum
maybe = meibi
meant = ment
miss = mis
month = mánth
moving = múviŋ
murder = murdur
none = nán
normal = normul
noticing = noutisiŋ
observed = obzurvd
odd = od
oh = ou
opportunity = opurcúniti
order = ordur
page = peij
paid = peid
Palantir = Palantir
personal = pursunul
Pi = Pai
pilot = pailut
plot = plot
points = points
portal = portul
prevent = privent
private = praivut
progress = prougres
pulled = púld
question = kwescun
ray = rei
reach = ryc
reading = rydiŋ
recall = rikol
reference = refruns
related = rileitud
resume = [rizhúm, rezúmei]
Ronik = Ronik
rush = rásh
sad = sad
sale = seil
scanned = skand
screaming = skrymiŋ
screen = skryn
seem = sym
self = self
series = siris
serve = surv
several = sevrul
Shane = Shein
share = sher
shelter = sheltur
shift = shift
shock = shok
shocked = shokd
shot = shot
shut = shát
skin = skin
slide = slaid
societies = sousaiutis
solution = sulúshun
sounds = saunds
spaceship = speisship
spent = spent
spread = spred
staircase = sterkeis
stalls = stols
stand = stand
standing = standiŋ
starting = startiŋ
stone = stoun
stops = stops
stress = stres
strong = stroŋ
structures = strákcurs
stuck = sták
subjects = sábjekts
sun = sán
supporting = suportiŋ
surrounded = suraundud
surrounding = suraundiŋ
switch = swic
task = tásk
tended = tendud
tendency = tendunsi
terminal = turminul
therefore = dherfor
throwing = throuiŋ
thugs = thágs
today's = túdeis
tone = toun
torch = torc
tough = táf
trolley = troli
two = toú
understood = ándurstúd
Valerie = Váluri
value = valiú
videos = vidious
Vietnamese = Vietnámyz
virtual = vurcúul
wakes = weiks
wanna = wánu
website = websait
weekly = wykli
whose = hoús
winning = winiŋ
Wintergarden = Winturgardun
woken = woukun
won't = wont
words = wurds
worked = wurkd
worse = wurs
yeah = yeh
yes = yes
yourself = yorself
Jamberoo = Jamburú
Sadako = Sádáko
Tweed = Twyd
abandoned = ubandund
ability = eibiliti
accessing = aksesiŋ
added = adud
against = ugenst
allowed = ulaud
alright = olrait
angry = aŋgri
announcement = unaunsmunt
antisocial = antisoushul
appear = upiur
applied = uplaid
applying = uplaiiŋ
April = Eiprul
architecture = arkitekcur
Arora = Árorá
arrive = uraiv
assumed = usúmd
attempt = utempt
attempted = utemptud
Australia = Ostreiliá
backgrounds = bakgraunds
badge = baj
bags = bags
bank = baŋk
banner = banur
bar = bar
barely = berli
basically = beisikuli
battery = baturi
becoming = bikámiŋ
bedroom = bedrúm
begin = bigin
belong = biloŋ
blade = bleid
blinking = bliŋkiŋ
blob = blob
blockchain = blokcein
boardgame = bourdgeim
book = búk
bother = bodhur
bothered = bodhurd
box = boks
brief = bryf
Brownvale = Braunveil
browser = brauzur
brute = brút
build = bild
bun = bán
cabin = kabin
calling = koliŋ
camera = kamurá
caravan = karuvan
care = ker
cars = kars
cat = kat
cause = koz
central = sentrul
characters = karakturs
chased = ceisd
cheese = cyz
childhood = caildhúd
choosing = cúziŋ
chosen = couzun
clothes = kloudhs
code = koud
comedy = komedi
comes = káms
comfy = kámfi
commerce = komurs
common = komun
commonwealth = komunwelth
competing = kompytiŋ
complete = komplyt
composed = kompouzd
consisted = konsistud
consulting = konsáltiŋ
contents = kontents
coordinator = ko'ordineitur
country = kántri
courage = kárij
crack = krak
cross = kros
crying = kraiiŋ
cunt = kánt
customer = kástumur
cuts = káts
cutting = kátiŋ
deciding = disaidiŋ
delivered = dilivurd
demanding = dimándiŋ
demonstrating = demunstreitiŋ
department = dipartmunt
describe = diskraib
developed = divelupd
device = divais
dialogue = daiulog
dimly = dimli
directed = dairektud
disappeared = disupiurd
discovered = diskávurd
disgust = disgást
display = displei
distorted = distortud
dog = dog
don = don
dot = dot
drew = droú
driver = draivur
Dunn = Dánn
edge = ej
effect = ifekt
effectively = ifektivli
electric = ilektrik
encounter = eŋkauntur
entirely = entaiurli
ever = evur
exam = eksam
excited = eksaitud
exclaimed = ekskleimd
exec = eksek
exhibit = eksibit
exhibits = eksibits
exiting = eksitiŋ
experienced = ekspiriunsd
explain = eksplein
extra = ekstrá
extreme = ekstrym
eyes = ais
fail = feil
fall = fol
fantasy = fantusi
feature = fycur
fellow = felou
festival = festivul
Fi = Fai
figure = figur
Fisher = Fishur
flame = fleim
flee = fly
focusing = foukusiŋ
footage = fútij
forget = forget
former = formur
frantically = frantikuli
frightened = fraitund
fuck = fák
Gaby's = Gabys
gang = gaŋ
gap = gap
garden = gardun
geeks = gyks
gesture = jescur
gives = givs
glasses = glásus
goal = goul
goes = gous
gonna = gonu
Google = Gúgul
grand = grand
greeted = grytud
gremlin = gremlin
grinder = graindur
guiding = gaidiŋ
hallway = holwei
happens = hapuns
hasn't = hazunt
hate = heit
haven't = havunt
headed = hedud
heads = heds
headset = hedset
hear = hiur
helpdesk = helpdesk
helping = helpiŋ
hey = hei
hit = hit
ho = hou
hooray = húrei
hosted = houstud
hotpot = hotpot
Ian = Iun
ignored = ignord
important = importunt
increasingly = iŋkrysiŋli
influenced = inflúunsd
ink = iŋk
inner = inur
install = instol
interview = inturviú
intimidating = intimideitiŋ
involving = involviŋ
isn't = izunt
jacaranda = jakurandá
Jason = Jeisun
Jimmy = Jimmy
joke = jouk
joking = joukiŋ
journey = jurni
kahoot = káhút
Katharine = Káthurin
kicked = kikd
kit = kit
kitchen = kicun
knock = nok
knocking = nokiŋ
Kungkung = Kúŋkúŋ
Kungkung's = Kúŋkúŋs
Lai = Lai
lane = lein
laptops = laptops
largely = larjli
Larry = Larry
lately = leitli
lawn = loon
lead = [led, lyd]
leads = [leds, lyds]
leftover = leftouvur
letter = letur
letters = leturs
levels = levuls
limited = limitud
lines = lains
listen = lisun
listened = lisund
lol = lol
lose = lúz
losing = lúziŋ
lounge = launj
Luhrmann = Luhrmann
Malay = Mulei
Malaysian = Muleishun
Malcolm = Malkulm
male = meil
manage = manij
Mario = Mariou
marks = marks
meanwhile = mynwail
memories = memoris
men's = mens
mention = menshun
mentioning = menshuniŋ
messages = mesijus
meteor = mytiur
mid = mid
min = min
mine = main
minute = minit
modern = modurn
Monday = Mándei
mood = múd
mostly = moustli
mother = mádhur
movement = múvmunt
moves = múvs
murals = miúruls
neon = nyon
network = netwurk
newfound = niúfaund
newly = niúli
news = niús
newsletter = niúsletur
Nicole = Nikoul
Nina = Niná
noodles = núduls
notes = nouts
object = objekt
occasional = oukeishunul
offered = ofurd
onion = ániun
opponent = upoununt
orange = orinj
ordered = ordurd
organisers = orgunaizurs
organising = orgunaiziŋ
Oscar = Oskur
otherwise = ádhurwaiz
overhead = ouverhed
overheard = ouverhurd
packing = pakiŋ
parts = parts
pass = pás
passwords = páswurds
path = páth
peers = piurs
pens = pens
Perria = Perriá
Phil = Fil
photo = foutou
piss = pis
pitch = pic
placed = pleisd
planned = pland
plates = pleits
plenty = plenti
poked = poukd
police = poulis
poor = pour
positive = positiv
potato = poteitou
potentially = potenshuli
powered = pauurd
prepare = priper
previously = priviusli
price = prais
prize = praiz
promo = proumou
promoting = promoutiŋ
property = propurti
pump = pámp
purpose = purpus
quiet = kwaiut
quiz = kwiz
race = reis
raised = reizd
rang = raŋ
reality = ryaliti
receiving = risyviŋ
recognise = rekunaiz
refuse = refiúz
regularly = regiúlurli
remind = rimaind
reminding = rimaindiŋ
repeatedly = ripytudli
resembled = rizembuld
resembles = rizembuls
resist = rizist
respond = respond
response = respons
restaurant = restront
resulting = rizoltiŋ
resumed = rizhúmd
retarded = ritardud
reveal = rivyl
revealing = rivyliŋ
roles = rouls
rounds = raunds
row = rou
rows = rous
rundown = rándaun
save = seiv
script = skript
seconds = sekunds
secret = sikrut
sense = sens
sent = sent
served = survd
service = survis
setup = setáp
severe = suviur
Shafiq = Sháfiq
shirts = shurts
shots = shots
shown = shoun
signs = sains
skills = skils
sleepy = slypi
smile = smail
smiling = smailiŋ
socialising = soushulaiziŋ
society's = sousaiutis
soft = soft
solve = solv
sometime = sámtaim
spend = spend
sport = sport
sports = sports
square = skwer
stack = stak
stairwell = sterwel
state = steit
stomach = stámuk
stored = stord
streets = stryts
strictly = striktli
struggled = stráguld
studied = stádid
successfully = suksesfúli
suggesting = sujestiŋ
superliner = súpurlainur
surreal = suryl
sushi = súshi
tactics = taktiks
tag = tag
taken = teikun
tamil = támil
tap = tap
tasks = tásks
teach = tyc
telling = teliŋ
templates = templeits
temple = tempul
terrible = teribul
Thai = Thai
thankfully = thaŋkfúli
thanks = thaŋks
that's = dhats
there's = dhers
thingy = thiŋi
Thomas = Thomus
thoughts = thoots
thousand = thauzund
throw = throu
ticket = tiket
tired = taiurd
tools = túls
totally = toutuli
touch = tác
townhouse = taunhaus
toy = toi
traffic = trafik
transport = tránsport
triangle = traiaŋgul
true = troú
tunnel = tánul
turns = turns
tutor = tiútur
typing = taipiŋ
unable = áneibul
underneath = ándurnyth
unfamiliar = ánfamiliur
uniform = yúniform
university's = yúnivursitis
upon = upon
vegetarian = vejiteriun
victim = viktum
violent = vailunt
visited = visitud
void = void
vote = vout
Wagner = Wágnur
wander = wondur
wandered = wondurd
warehouse = werhaus
wear = wer
welcomed = welkámd
weren't = wurnt
what's = wáts
whatever = wátevur
whenever = wenevur
wherever = werevur
William = Willium
witness = witnus
wondering = wánduriŋ
worry = wuri
wrote = rout
Xie = Xie
yelling = yeliŋ
yesterday = yesturdei
yielded = yyldud
absolutely = absulútli
AcademyXI = AkudemiksI
accepted = akseptud
accompany = ukámpuni
Acer = Eisur
acquaintances = ukweintunsus
acquired = ukwaiurd
activity = aktiviti
address = adrus
administrator = administreitur
adopt = udopt
adult = udált
adults = událts
advertised = ádvurtaizd
advice = advais
African = Áfrikun
ahead = uhed
aimlessly = eimlusli
airline = erlain
algorithm = alguridhum
allegedly = ulejudli
allocated = alokeitud
AlphaGo = ÁlfáGou
alternate = olturnut
aluminium = alúminium
analysis = anulisis
analytics = anulitiks
ancient = einshunt
angle = aŋgul
announcements = unaunsmunts
annoyed = unoid
annual = aniúul
appearance = upiuruns
application = aplikeishun
apply = uplai
appreciate = uprishieit
Aquilina = Áquiliná
Arab = Áráb
arm = arm
arrival = uraivul
arrives = uraivs
art = art
articles = artikuls
artificial = artifishul
asleep = uslyp
aspects = aspekts
assembled = usembuld
assembling = usembliŋ
assigned = usaind
assist = usist
assistance = usistuns
attacked = utákd
attitude = atitiúd
Aussie = Ozi
automatically = otomatikuli
awake = uweik
backpack = bakpak
badges = bajus
badly = badli
baggage = bagij
batch = bac
bathroom = báthrúm
bathrooms = báthrúms
beautiful = biútiful
becomes = bikáms
befriended = bifrendud
beginner = biginur
beginners = biginurs
begins = bigins
believe = bilyv
believed = bilyvd
Bhatt = Bhátt
biggest = bigust
binaries = bainuris
Binil = Binil
biology = baiolouji
bitch = bic
blurred = blurd
boarded = bourdud
boardwalk = bourdwook
boat = bout
bomb = bom
booming = búmiŋ
boss = bos
bottle = botul
bowel = báwul
bowing = bouiŋ
brain = brein
branches = bráncus
branded = brandud
breaking = breikiŋ
breaks = breiks
brightly = braitli
bucket = bákit
built = bilt
bulgogi = búlgougi
bunch = bánc
burning = burniŋ
burnt = burnt
bushfire = búshfaiur
businessmen = bisnusmen
butt = bát
button = bátun
buying = baiiŋ
Cabramatta = Kábrámáttá
cake = keik
calls = kols
canister = kanistur
capable = keipubul
Caragh = Kuragh
cardboard = kardbourd
career = kuriur
carefully = kerfuli
cartridge = kartrij
catch = kac
cautiously = kooshusli
cave = keiv
celebrate = selubreit
cereal = siriul
challenges = calunjus
changes = ceinjus
chanting = cántiŋ
chap = cap
charged = cárjd
checked = cekd
chiptune = ciptiún
choice = cois
choices = coisus
chorus = korus
chose = couz
Christmas = Krismus
chromium = kroumium
circumstances = surkumstansus
clarify = klarifai
classes = klásus
classroom = klásrúm
clean = klyn
cleaning = klyniŋ
cliff = klif
climb = klaimb
climbing = klaimbiŋ
clustered = klásturd
cockroaches = kokroucus
cold = kould
collected = kolektud
coloured = kálurd
combined = kombaind
comfortable = kámfurtubul
command = kománd
commuters = komiúturs
competitions = komputishuns
complained = kompleind
completely = komplytli
computing = kompiútiŋ
concept = konsept
concurrently = koŋkáruntli
confirming = konfurmiŋ
confront = konfránt
confusion = konfiúzhun
considered = konsidurd
containing = konteiniŋ
continuing = kontiniúiŋ
contrasted = kontrástud
control = kontroul
copies = kopis
core = kour
correct = korekt
corridor = koridor
couch = kauc
coupon = koúpon
course = kours
cousins = kázuns
CPUs = CPUs
crashing = krashiŋ
crawl = krool
crawled = kroold
crazy = kreizi
created = krieitud
creeped = krypd
crowd = kraud
cruise = kroúz
crust = krást
cubicle = kiúbikul
cup = káp
curry = kári
custom = kástum
daring = deriŋ
date = deit
David's = Deivids
daytime = deitaim
deadly = dedli
deck = dek
definitely = definutli
delayed = dileid
demo = demou
density = densiti
Deon = Dyon
deploy = diploi
describing = diskraibiŋ
description = diskripshun
desire = dizaiur
desired = dizaiurd
destination = destuneishun
destinations = destuneishuns
destroyed = distroid
destroying = distroiiŋ
detailing = diteiliŋ
details = diteils
develop = divelup
developer = divelupur
developing = divelupiŋ
died = daid
difference = difruns
dimmer = dimur
dip = dip
dirty = durti
disappointed = disupointud
disapproval = disuprúvul
disaster = dizástur
discover = diskávur
discussion = diskáshun
distracted = distraktud
disturbing = disturbiŋ
dive = daiv
dominating = domineitiŋ
Domino's = Dominous
donated = douneitud
donations = douneishuns
donors = dounurs
dozing = douziŋ
drama = drámá
draw = droo
drawn = droon
dreaming = drymiŋ
drink = driŋk
driver's = draivurs
driveway = draivwei
drop = drop
drove = drouv
dunno = dunou
dynamic = dainamik
earphones = iurfouns
eats = yts
economics = ekonomiks
educated = ejúkeitud
Einstein = Ainstain
elevators = eliveiturs
elsewhere = elswer
emails = imeils
emergency = imurjunsi
emitted = emitud
Emmanuel = Immaniúul
employees = emploiys
enclosed = eŋklouzd
ending = endiŋ
enemies = enumis
enquired = eŋkwaiurd
entertainment = enturteinmunt
equally = ykúuli
equipment = ikwipmunt
escaped = eskeipd
evening = yvuniŋ
everywhere = evriwer
evil = yvul
exceeded = eksydud
exercise = eksursaiz
exited = eksitud
experiencing = ekspiriunsiŋ
explode = eksploud
exploded = eksploudud
exploits = eksploits
facts = fakts
failed = feild
fails = feils
falls = fols
famous = feimus
fancy = fansi
faster = fástur
father = fádhur
Febian = Febiun
february = Febiúuri
feels = fyls
feet = fyt
fest = fest
fictional = fikshunul
fidget = fijit
fighting = faitiŋ
figured = figurd
fill = fil
filling = filiŋ
filth = filth
filthy = filthi
finishes = finishus
fish = fish
fist = fist
flags = flags
focus = foukus
fold = fould
foldable = fouldubul
folded = fouldud
foodie = foúdi
foot = fút
force = fors
forcefully = forsfúli
forth = forth
framework = freimwurk
Fran = Fran
freedom = frydum
Freelancer = Frylánsur
frequently = frykúuntli
fresh = fresh
fridge = frij
frustration = frástreishun
fucked = fákd
fundraising = fándreisiŋ
gabber = gabbur
game's = geims
gas = gas
gates = geits
gear = giur
geek = gyk
gently = jentli
gets = gets
giggling = gigliŋ
gloomy = glúmi
glowing = glouiŋ
goody = gúdi
gotten = gotun
gourmet = gormei
grew = groú
guard = gard
guest = gest
guide = gaid
hair = her
halfway = hálfwei
halls = hols
Hamish = Heimish
handed = handud
handwritten = handritun
hang = haŋ
harbour = harbur
hated = heitud
haze = heiz
he's = hys
headache = hedeik
health = helth
hello = helou
helpful = helpfúl
hesitant = hezitunt
hesitation = heziteishun
hiding = haidiŋ
higher = haiur
highly = haili
hill = hil
hills = hils
Hitler = Hitlur
hobby = hobi
hopefully = houpfúli
hoping = houpiŋ
host = houst
hostility = hostiliti
hosting = houstiŋ
huge = hiúj
Hume = Hiúm
hundred = hándrud
hungry = háŋgri
hurt = hurt
ignoring = ignoriŋ
illuminated = ilúmineitud
immersed = imursd
implementation = implumunteishun
imposed = impouzd
improved = imprúvd
inclusion = iŋklúzhun
increasing = iŋkrysiŋ
incumbent = iŋkámbunt
indicating = indikeitiŋ
Indonesia = Indonesiá
infamous = infeimus
initial = inishul
initiating = inishieitiŋ
instructions = instrákshuns
intentions = intenshuns
interacted = inturaktud
interactions = inturakshuns
interchange = inturceinj
interconnected = inturkonektud
intro = introu
introduce = introdiús
introduces = introdiúsus
investigate = investigeit
involved = involvd
issue = ishú
itself = itself
Japan = Japan
Java = Jává
jet = jet
jonathan = Jonuthun
July = Júlai
jump = jámp
Kali = Káli
keeping = kypiŋ
Kevin = Kevin
killed = kild
kinda = kaindu
Kiran = Kirun
kits = kits
knows = nous
Kyu = Kyú
laid = leid
lake = leik
lanyard = lanyard
lattice = latis
launched = looncd
laundry = loondri
leaked = lykd
leaves = lyvs
lemak = lumák
lighting = laitiŋ
limit = limit
limiting = limitiŋ
liquid = likwid
listening = lisuniŋ
Liu = Liú
lively = laivli
lives = livs
longboard = loŋbourd
loose = loús
loves = lávs
lower = louur
loyal = loyul
luminous = lúminus
lunchbox = láncboks
machines = mushyns
magical = majikul
mainly = meinli
malls = mols
map = map
mar = mar
marine = muryn
mark = mark
massive = masiv
masters = másturs
math = math
matter = matur
maze = meiz
McFarlane = McFarlein
Melbourne = Melburn
meme = mym
metro = metrou
midway = midwei
milk = milk
mini = mini
mirrors = mirurs
mistakes = misteiks
mitchell = mitcul
mix = miks
mobile = moubail
model = modul
modems = moudems
moment = moumunt
monotonous = monutounus
months = mánths
motive = moutiv
multi = málti
museum = miúzium
mushroom = máshrúm
named = neimd
nap = nap
nasi = nási
natural = nacurul
nearest = niurest
neck = nek
needles = nyduls
neighbour = neibur
neighbouring = neiburiŋ
neighbours = neiburs
nervous = nurvus
networking = netwurkiŋ
nevertheless = nevurdhules
newspaper = niúspeipur
nightmares = naitmers
nil = nil
node = noud
nodes = nouds
noisy = noizi
north = north
northeast = northyst
notable = noutubul
noticably = noutisubli
objects = objekts
obscure = obskiúur
occupants = okiúpunts
occupied = okiúpaid
occur = ukur
officer = ofisur
offices = ofisus
often = oftun
oily = oili
okay = oukei
older = ouldur
one's = wáns
opening = oupuniŋ
operate = opureit
operating = opureitiŋ
operation = opureishun
opportunities = opurtúnitis
organisation = orgunaizeishun
organisations = orgunaizeishuns
original = orijinul
other's = ádhurs
outdated = autdeitud
outlining = autlainiŋ
owned = ound
painting = peintiŋ
pair = per
papa's = Pápás
parked = parkd
participants = partisipunts
password = páswurd
patrons = peitruns
payload = peiloud
payment = peimunt
pen = pen
penis = pynis
performance = purformuns
Perrian = Perriun
Phoebe = Fybi
physically = fizikuli
picking = pikiŋ
picnic = piknik
pide = pide
piece = pys
pinion = piniun
pitched = picd
plants = plánts
podium = poudium
pointed = pointud
pointing = pointiŋ
politely = polaitli
popped = popd
popular = popiúlur
porn = porn
porthole = porthoul
portrayed = portreid
positioned = pozishund
posters = pousturs
postgraduate = poustgrajúut
practical = praktikul
pram = pram
preferred = prifurd
presume = prizhúm
Prijatna = Prijátná
primarily = praimarili
printed = printud
printing = printiŋ
prizes = praizus
proceeded = prosydud
professor = profesur
professors = profesurs
progressed = progresd
projector = projektur
projects = projekts
promised = promisd
promoted = promoutud
protagonist = protagunist
provide = provaid
provided = provaidud
pulling = púliŋ
pushed = púshd
queues = kiús
quick = kwik
quit = kwit
quote = kwout
railway = relwei
rain = rein
randomness = randumnus
rap = rap
rapist = reipist
Rayen = Reiyun
reaching = ryciŋ
react = riakt
reactions = riakshuns
reader = rydur
receive = risyv
recent = risunt
receptionist = risepshunist
reckless = reklus
recorded = rikordud
recording = rikordiŋ
recruit = rikrút
refer = rifur
references = refrunsus
refused = rifiúzd
refusing = rifiúziŋ
rejected = rijektud
relationship = rileishunship
releasing = rilysiŋ
relief = rilyf
remain = rimein
reminds = rimainds
removed = rimúvd
rendered = rendurd
replacement = ripleismint
republic = ripáblik
research = risurc
resort = rizort
responder = respondur
responsible = responsibul
results = rizolts
returning = riturniŋ
reward = riword
rice = rais
rich = ric
rid = rid
rock = rok
rocky = roki
roll = roul
romantic = roumantik
rooms = rúms
Roslan = Roslán
round = raund
rude = roúd
rudeness = roúdnus
rushed = ráshd
safety = seifti
sails = seils
salad = salud
sample = sampul
sanctions = saŋkshuns
sandstone = sandstoun
sauce = soos
scars = skars
schooler = skúlur
schoolgirls = skúlgurls
scrolling = skrouliŋ
seat = syt
seated = sytud
seats = syts
secluded = seklúdud
second = sekund
sections = sekshuns
seduce = sediús
sees = sys
Seiko = Seikou
selected = sulektud
selfie = selfy
sell = sel
sentences = sentunsus
separated = sepureitud
settled = setuld
sewer = soúur
sexy = seksi
shade = sheid
shaded = sheidud
shaked = sheikd
shall = shal
shared = sherd
Shaun = Shoon
ship = ship
shit = shit
shoes = shús
shop = shop
shorter = shortur
shows = shous
Sichuanese = Sicúányz
sidenote = saidnout
sight = sait
silent = sailunt
silly = sili
simple = simpul
sinister = sinistur
sister's = sisturs
site = sait
sits = sits
situation = sicúeishun
sized = saizd
skate = skeit
skateboard = skeitbourd
Skribbl = Skribbl
slammed = slamd
slides = slaids
slogan = slougun
slogans = slouguns
sloped = sloupd
slopes = sloups
smell = smel
smelled = smeld
smelly = smeli
smooth = smoúdh
snake = sneik
sobbing = sobiŋ
sorcerer = sorsurur
sorry = sori
sounded = saundud
sources = sorsus
southwest = sauthwest
spacious = speishus
specifically = spusifikuli
speeches = spycus
speedcore = spydkour
speeding = spydiŋ
spiky = spaiki
spinner = spinur
split = split
sponsor = sponsur
spray = sprei
stage = steij
stare = ster
startups = stártáps
statement = steitmunt
stayed = steid
steps = steps
stick = stik
stones = stouns
storey = stori
straight = streit
stranger = streinjur
strangers = streinjurs
strategy = stratuji
stronger = stroŋgur
structure = strákcur
struggling = stráguliŋ
stuffed = stáfd
style = stail
submerged = sábmurjd
suburban = sáburbun
subway = sábwei
succeeded = suksydud
suggest = sujest
suggests = sujests
supernatural = súpurnacurul
superstitious = súpurstishus
supposed = supouzd
surroundings = suraundiŋs
suspect = sáspekt
swim = swim
symbolises = simbulaizus
systems = sistums
tacos = tákous
talks = tooks
Tangara = Tángárá
tarp = tarp
tasted = teistud
teachers = tycurs
teenage = tyneij
tent = tent
terminate = turmineit
terminates = turmineits
terminus = turminus
terms = turms
test = test
testers = testurs
themes = thyms
thesis = thysus
thick = thik
thin = thin
thus = dhás
tile = tail
Ting = Tiŋ
tip = tip
title = taitul
tonight = túnait
topic = topik
topics = topiks
touched = tácd
tournament = túrnumunt
towel = táwul
Toyota = Toyotá
trace = treis
trackless = traklus
tracks = traks
train's = treins
training = treiniŋ
trains = treins
travelling = tráveliŋ
Travis = Travis
tree = try
trick = trik
truncated = tráŋkeitud
tutors = tiúturs
twice = twais
twisted = twistud
typed = taipd
ultrabook = áltrábúk
understanding = ándurstandiŋ
unexpected = ánekspektud
unfolded = ánfouldud
unique = yúnyk
unit = yúnit
Unix = Yúniks
unorthodox = ánorthudoks
upgrade = ápgreid
upset = ápset
urinals = yúrinuls
urine = yúrin
useful = yúsfúl
variant = variunt
variety = vuraiuti
vast = vást
vegetarians = vejiteriuns
veggies = vejis
verse = vurs
versing = vursiŋ
videogame = vidiougeim
violently = vailuntli
Virtualbox = Vurcúulboks
voices = voisus
volunteered = voluntiurd
voting = voutiŋ
walks = wooks
Wang = Wáŋ
wanting = wántiŋ
wants = wánts
wardrobe = wordroub
watched = wacd
ways = weis
weak = wyk
weapons = wepuns
weather = wedhur
web = web
WhatsApp = WátsAp
wheels = wyls
whilst = wailst
winner = winur
wires = waiurs
wooden = wúdun
worn = worn
worrying = wuriiŋ
worth = wurth
wrapped = rapd
wrist = rist
ya = yá
Yose = Yose
Youtube = Yútiúb
Zoe = Zoui
Alice = Alis
Astua = Ástúá
backup = bakáp
border = bordur
chemistry = kemistri
Chocolatey = Cokluti
crush = krásh
Frank = Fraŋk
Funch = Fánc
glorious = glorius
Hawaii = Háwaii
Jess = Jess
knight = nait
passphrases = pásfreizus
punishment = pánishmunt
putty = páti
relax = rilaks
respectable = respektubul
seconded = sekundud
simultaneous = simulteinius
stressed = stresd
tight = tait
touching = táciŋ
warmups = wormáps
absence = absuns
absentmindedly = absuntmaindudli
absymal = absimul
academically = akudemikuli
accept = aksept
accepting = akseptiŋ
accidentally = aksidentuli
accomodate = ukomudeit
accomplished = ukomplishd
accord = ukord
account = ukaunt
accumulated = ukiúmiúleitud
accurately = akiúrutli
accusing = ukiúziŋ
achieved = ucyvd
achiever = ucyvur
acid = asid
acronyms = akrunims
acted = aktud
action = akshun
actions = akshuns
activated = aktiveited
active = aktiv
Adam = Adum
adapted = udaptud
adapter = udaptur
add = ad
adding = adiŋ
addressed = adrusd
addresses = adrusus
addressing = udresiŋ
admin = admin
administrator = administreitur
admired = admaiurd
admiring = admaiuriŋ
admit = admit
admitted = admitud
adopted = udoptud
advances = advánsus
advantage = advántij
advantageous = advántijus
advertises = advurtaizus
advise = advais
aeroplane = erouplein
aesthetic = asthetik
affectionate = ufekshunut
affiliated = ufilieitud
affirming = ufrumiŋ
affordable = ufordubul
aforementioned = uformenshund
afraid = ufreid
afterward = áfturwurd
ages = eijus
aggressions = ugreshuns
aggressive = ugresiv
agree = ugry
ahem = ahum
Ahmad = Áhmád
aims = eims
aircraft = erkráft
airlines = erlains
aisles = ails
alas = álás
algorithms = álguridhums
alignment = ulainmunt
alike = ulaik
alleged = ulejd
allowance = ulauuns
almond = almund
altercation = olturkeishun
alternative = olturnutiv
altitude = altitiúd
altogether = oltúgedhur
amazing = umeiziŋ
Amazon's = Amuzons
ambushed = ambúshd
America = Ámeriká
American = Ámerikun
amp = amp
amphitheatre = amfithiutur
amusement = umiúzmunt
ancestry = ansestri
android = android
ang = áŋ
Angela = Anjulá
angels = einjuls
anger = aŋgur
angles = aŋguls
annoying = unoiiŋ
anonymous = unonimus
answers = ánsurs
anthropology = ánthrupoloji
anticipation = antisipeishun
antisociality = antaisoushuliti
apart = upart
ape = eip
apocalyptic = upokuliptik
apologise = upolujaiz
apologising = upolujaiziŋ
apparent = uparunt
appreciated = uprishieitud
appropriate = uproupriut
approval = uprúvul
approximately = uproksimutli
apps = aps
aquatic = ukwotik
arcade = arkeid
arch = árc
Arduino = Ardúinou
areas = erius
Armenian = Armyniun
arms = arms
Armstrong = Armstroŋ
arrange = ureinj
arrangement = ureinjmunt
arrest = urest
arriving = uraiviŋ
artist = artist
arts = arts
ass = ass
assemble = usembul
assessment = usesmunt
associated = usoushieitud
assuming = usúmiŋ
atmosphere = atmusfiur
atom = atum
atomic = utomik
attached = utácd
attack = utak
attacks = utaks
attendee = utendy
attract = utrakt
attracted = utraktud
attractive = utraktiv
audio = oodiou
authors = oothurs
automated = ootomeited
avalanche = avulánc
avocado = avokádou
await = uweit
awakening = uweikuniŋ
awaking = uweikiŋ
aware = uwer
awkwardness = ookwurdnus
baby = beibi
backdrop = bakdrop
baffled = bafuld
Bahasa = Báhásá
balanced = balunsd
balcony = balkuni
ballpoint = bolpoint
banana = bunáná
Bandung = Bándúŋ
bang = baŋ
banh = bánh
Bankwest = Baŋkwest
banners = banurs
barcode = barkoud
barrage = barázh
barriers = bariurs
Barry = Barry
bars = bars
base = beis
basement = beismunt
bash = bash
basis = beisus
bathtub = báthtáb
batteries = batris
battle = batul
beach = byc
bear = ber
bearing = beriŋ
bears = bers
beaten = bytun
beating = bytiŋ
beauty = biúti
beetroot = bytrút
befriending = bifrendiŋ
beggars = begurs
behaviour = biheiviur
beliefs = bilyfs
believing = bilyviŋ
belt = belt
benches = bencus
benefits = benifits
Benjamin = Benjumin
berated = bireitud
berry = beri
beyond = biyond
bias = baius
bid = bid
bigger = bigur
bike = baik
billboard = bilbourd
billion = biliun
biochemistry = baiokemistri
bits = bits
bizarre = bizar
blackboards = blakbourds
blades = bleids
blazing = bleiziŋ
bleak = blyk
blended = blendud
blinding = blaindiŋ
blobs = blobs
blockchains = blokceins
blocked = blokd
blocky = bloki
blonde = blond
blood = blád
blow = blou
boarding = bourdiŋ
boards = bourds
bodies = bodis
bogan = bougun
bold = bould
boobs = boúbs
booked = búkd
booking = búkiŋ
boost = boúst
boosting = boústiŋ
booty = boúti
boredom = bordum
born = born
bosses = bosus
bothers = bodhurs
bought = boot
bouldering = boulduriŋ
bout = baut
boxes = boksus
boy's = bois
boyfriend = boifrend
Brad = Brad
branch = bránc
brave = breiv
breakfast = brekfust
Brent = Brent
brick = brik
bricks = briks
bridge = brij
bridges = brijus
brigades = brigeids
bring = briŋ
bringing = briŋiŋ
British = British
broadcaster' = broudkástur
broken = broukun
brother's = brádhurs
browsed = brauzd
brush = brásh
brushed = bráshd
buckets = bákits
buffer = báfur
bule = búle
bull = búl
bullet = búlut
bumpy = bámpi
bundles = bánduls
bungalow = báŋgulou
burglar = burglur
buried = berid
burst = burst
bursting = burstiŋ
buses = básus
bushfires = búshfaiurs
bushland = búshland
bushy = búshi
business = bisnus
butter = bátur
buttons = bátuns
Callum = Kallum
calm = kálm
calms = kálms
camera's = kamurás
campaign = kampein
Campbell = Kampbell
Canada = Kanudá
cancelled = kansuld
canned = kand
cannon = kanun
canteen = kantyn
captured = kapcurd
cardgame = kardgeim
cards = kards
cared = kerd
careers = kuriurs
careful = kerfúl
carpark = karpark
Catan = Kután
catches = kacus
catchy = kaci
caused = kozd
causing = koziŋ
celebrations = selubreishuns
centred = senturd
Centrelink = Senturliŋk
centres = senturs
century = sencuri
certainly = surtunli
certificates = surtifikuts
cha = cá
chain = cein
chair = cer
champagnes = shampeins
changing = ceinjiŋ
Chaozhou = Chauzhou
characterisation = karakturaizeishun
characteristics = karakturistiks
charitable = caritubul
charity = cariti
chart = cart
chase = ceis
Chatswood = Catswúd
chatter = catur
chattering = caturiŋ
cheap = cyp
cheaper = cypur
cheeks = cyks
cheerful = ciurfúl
cheerfully = ciurfúli
cheering = ciuriŋ
cheery = ciuri
cheeseburger = cyzburgur
cheesy = cyzi
Chen = Cen
chicks = ciks
chill = cil
chilling = ciliŋ
China = Cainá
chips = cips
chitchat = citcat
chopped = copd
Christina = Kristiná
Christy = Kristy
chuck = cák
cinematic = sinumatik
cipher = saifur
ciphertext = saifurtekst
circles = surkuls
citizens = sitizuns
Cityrail = Sitirel
civic = sivik
civilization = sivilaizeishun
clad = klad
claimed = kleimd
clarification = klarifikeishun
clarifying = klarifaiiŋ
classic = klásik
classical = klásikul
clause = klooz
cleaned = klynd
clearing = kliuriŋ
clearly = kliurli
clicked = klikd
client = klaiunt
clinging = kliŋiŋ
clock = klok
closer = klousur
closet = klozit
closing = klouziŋ
clouds = klauds
clown = klaun
coast = koust
coaster = koustur
coastline = koustlain
coat = kout
coders = koudurs
Cody's = Kodys
coincidentally = kouinsidentuli
Coles = Couls
colleague = kolig
colleagues = koligs
collecting = kolektiŋ
collection = kolekshun
college = kolij
colour = kálur
colours = kálurs
column = kolum
columns = kolums
com = kom
combinations = kombineishuns
comfort = kámfurt
commands = kománds
comment = koment
comments = koments
commercial = komurshul
commotion = komoushun
communicating = komiúnikeitiŋ
commuter = komiútur
compensate = kompenseit
competitors = kompetiturs
compile = kompail
complaining = kompleiniŋ
complains = kompleins
completed = komplyted
completion = komplyshun
complexity = kompleksiti
compliment = kompliment
composer = kompouzur
conceived = konsyvd
concentric = konsentrik
concludes = koŋklúds
conclusion = koŋklúzhen
concocted = koŋkoktud
concocting = koŋkoktiŋ
condiments = kondimunts
condition = kondishun
conditioning = kondishuniŋ
conduct = kondákt
conducting = kondáktiŋ
conferencing = konfrunsiŋ
confess = konfes
confessed = konfesd
confesses = konfesus
confident = konfidunt
configuration = konfigureishun
confirm = konfurm
confirmed = konfurmd
conform = konform
confronted = konfránted
confronts = konfránts
confusing = konfiúziŋ
congratulated = kongracúleitud
connector = konektur
connotation = konoteishun
consider = konsidur
constant = konstunt
constitution = konstitiúshun
constricted = konstriktud
construction = konstrákshun
constructive = konstráktiv
consumes = konsiúms
consumption = konsámpshun
contact = kontakt
contacting = kontaktiŋ
contain = kontein
containers = konteinurs
contestant = kontestunt
contrast = kontrást
contribute = kontribiút
controlled = kontrould
conversational = konvurseishunul
conversations = konvurseishuns
converse = konvurs
conversing = konvursiŋ
conveyed = konveid
convince = konvins
cookies = kúkis
cooking = kúkiŋ
cooling = koúliŋ
coordinate = ko'ordinet
copperplate = kopurpleit
copy = kopi
corrode = koroud
corrupted = koráptud
costed = kostud
costume = kostiúm
couches = kaucus
coughing = kofiŋ
count = kaunt
counter = kauntur
counting = kauntiŋ
couples = kápuls
covering = kávuriŋ
covid = kouvid
cracked = krakd
crackling = krakliŋ
craft = kráft
crafted = kráftud
crafts = kráfts
cranes = kreins
crate = kreit
create = krieit
creative = krieitiv
creativity = krieitiviti
creature = krycur
creep = kryp
creeps = kryps
crescent = kresunt
criminal = kriminul
criteria = kraitiriá
criticism = kritisizum
cronyism = krouniizum
crossing = krosiŋ
cryptic = kriptik
cubicles = kiúbikuls
cultural = kalcurul
cumbersome = kámbursum
cummed = kámd
cups = káps
curiosity = kiúriositi
curious = kiúrius
curiously = kiúriusli
curse = kurs
cursed = kursd
curtains = kurtuns
curved = kurvd
custserv = kástsurv
cutie = kiúti
cutlery = kátluri
cybersecurity = saibursikiuriti
cycling = saikuliŋ
Daiso = Daisou
damaged = damijd
dancefloor = dansflor
danger = deinjur
dangerous = deinjurus
dare = der
darker = darkur
darling = darliŋ
dashed = dashd
database = deitábeis
databases = deitábeisus
dating = deitiŋ
dead = ded
dealing = dyliŋ
Deanna's = Dyannás
debates = dibeits
decay = dikei
decimal = desimel
decision = disizhen
decorated = dekoreitud
decorations = dekoreishuns
dedicated = dedikeitud
deeper = dypur
defeated = difytud
defeats = difyts
defecated = defikeitud
deficiency = difishunsi
degrees = digrys
delay = dilei
deleted = dilytud
deleting = dilytiŋ
deliberately = dulibrutli
delicious = dilishus
deliver = dilivur
demand = dimánd
demolished = dimolishd
demonstrated = demunstreitud
Deon's = Dyons
depart = dipart
departing = dipartiŋ
departure = diparcur
dependent = dipendunt
depending = dipendiŋ
depends = dipends
depicting = dipiktiŋ
depiction = dipikshun
depressed = dipresd
depressing = dipresiŋ
depriving = dipraiviŋ
deserves = dizurvs
designed = dizaind
desires = dizaiurs
desks = desks
desktop = desktop
desolate = desulut
despair = disper
desperation = despureishun
despicable = dispikubul
destiny = destuni
destroy = distroi
determine = deturmin
determined = diturmind
development = divelupmunt
Devi = Devi
devoted = divoutud
devotees = devotys
diarrhoea = daiuriu
diary = daiuri
die = dai
dies = dais
digits = dijits
dim = dim
direct = dairekt
disappearing = disupiuriŋ
disappointing = disupointiŋ
disasters = dizásturs
disconnected = diskonektud
discount = diskaunt
discounted = diskauntud
discovering = diskavuriŋ
discrimination = diskrimineishun
discussing = diskásiŋ
disguise = disgaiz
disgusted = disgástud
dishes = dishus
dismay = dismei
displayed = displeid
disposable = dispouzubul
disrupting = disráptiŋ
distancing = distunsiŋ
distinct = distiŋkt
distinguished = distiŋgwishd
distracting = distraktiŋ
distro = distrou
diversity = daivursiti
divided = divaidud
docs = doks
documentary = dokiúmenturi
dodgy = doji
dogs = dogs
dominated = domineitud
doom = dúm
doomed = dúmd
doorway = dorwei
Doritos = Doritos
doubt = daut
Dougal = Doúgul
downloaded = daunloudud
draft = dráft
dragged = dragd
drags = drags
dramatic = drumatik
dramatically = drumatikuli
drawer = droowur
drawful = droofúl
drawings = droowiŋs
drawl = drool
dream's = dryms
dreamed = drymd
dried = draid
drinking = driŋkiŋ
driverless = draivurlus
drives = draivs
drone = droun
dropped = dropd
drowsiness = drauzinus
drowsy = drauzi
drumstick = drámstik
duckling = dákliŋ
dusk = dásk
dust = dást
eagerly = ygurli
ear = iur
earn = urn
earning = urniŋ
ears = iurs
easiest = yziust
east = yst
easy' = yzi
eaten = ytun
eccentric = eksentrik
ecosystem = ikousistum
eerie = yri
eerily = yrili
Efron = Efrun
eftpos = Eftpos
Eileen = Ailyn
elaborate = ilaburut
elder = eldur
elections = ilekshuns
electrical = ilektrikul
electrified = ilektrifaid
elements = elimunts
elephant = elifunt
elephants = elifunts
eliminate = elimineit
elongated = iloŋgeitud
Eman = Iman
embraced = embreisd
embracing = embreisiŋ
emerges = imurjus
Emily = Emily
emitting = emitiŋ
emoji = imouji
emotional = imoushunul
emotionally = imoushnuli
emotions = imoushuns
emphasised = emfusaizd
employers = emploiurs
employs = emplois
enclosement = enklousmunt
encompassing = eŋkámpusiŋ
encountering = eŋkaunturiŋ
encouragement = eŋkárijmunt
encrypted = eŋkriptud
ends = ends
engine = enjin
engineer' = enjiniur
engineers = enjiniurs
engulfed = ingálftd
enjoy = enjoi
enjoyable = enjoiubul
enjoyed = enjoid
enjoying = enjoiiŋ
enjoyment = enjoimunt
enjoys = enjois
enlarged = enlarjd
enlightenment = enlaitunmunt
enrolled = enrould
ensure = enshur
ensuring = enshuriŋ
environments = invairunmunts
epic = epik
episode = episoud
eradication = iradikeishun
erase = ireis
errors = erurs
escape = eskeip
Esrah = Esráh
estate = esteit
estates = esteits
ethnic = ethnik
ethnicity = ethnisiti
Euan = Yúun
europe = Yúroup
european = Yúroupiun
Eventbrite = Iventbrait
everybody = evribádi
exact = iksakt
examine = eksamin
examined = eksamind
examples = eksámpuls
excess = ekses
exchange = eksceinj
exchanged = eksceinjd
exclaim = ekskleim
excursions = ekskurzhuns
excused = ekskyúzd
exhibiting = eksibitiŋ
exhilarating = eksilireitiŋ
existed = iksistud
existence = iksistuns
existing = iksistiŋ
expand = ekspand
expect = ekspekt
expectations = ekspekteishuns
expecting = ekspektiŋ
expense = ekspens
expensive = ekspensiv
experiments = ekspirimunts
explicit = eksplisit
exploding = eksploudiŋ
exploit = eksploit
exploited = eksploitud
explorer = eksplorur
explores = eksplors
explosion = eksplouzhun
expose = ekspouz
exposing = ekspouziŋ
expressed = ekspresd
extended = ekstendud
extension = ekstenshun
extensively = ekstensivli
extinguished = ekstiŋgwishd
extractor = ekstraktur
extracurricular = ekstrákurikiúlur
extravagant = ekstravugunt
eye = ai
facade = fusád
Facebook's = Feisbúks
facilities = fusilitis
failing = feiliŋ
faint = feint
fair = fer
fairly = ferli
fake = feik
falcon = falkun
false = fols
familial = familiul
fangs = faŋs
fantasies = fantusis
farewell = ferwel
fart = fart
farted = fartud
fashioned = fashund
fat = fat
fate = feit
father's = fádhurs
fathered = fádhurd
fatso = fatsou
fatter = fatur
faulty = folti
favour = feivur
features = fycurs
federation = fedureishun
feedback = fydbak
fell = fel
fellas = felus
females = fymeils
fence = fens
fetal = fytul
fidler = faidulur
fields = fylds
Fife = Faif
fifty = fifti
fight = fait
files = fails
Filipino = Filipinou
fillets = filuts
fills = fils
films = films
filthiness = filthinus
finds = fainds
finely = fainli
firearms = faiurarms
fireplace = faiurpleis
fitted = fitud
fix = fiks
flames = fleims
flaming = fleimiŋ
flammable = flamubul
flashback = flashbak
flavour = fleivur
flaws = floos
flea = fly
fled = fled
fleeing = flyiŋ
flew = floú
flexibility = fleksibiliti
flipped = flipd
flips = flips
flirting = flurtiŋ
floating = floutiŋ
flowers = fláwurs
flowing = flouiŋ
flown = floun
fluorescent = flúuresunt
flyover = flaiouvur
foam = foum
folder = fouldur
follows = folous
font = font
forbidden = forbidun
forehead = forhed
forgetting = forgetiŋ
forming = formiŋ
forms = forms
forward = forwurd
forwards = forwurds
frame = freim
freak = fryk
freaks = fryks
freebie = frybi
freeway = frywei
frying = fraiiŋ
fudged = fájd
funded = fándud
funny = fáni
furniture = furnicur
further = furdhur
furthest = furthust
fuselage = fiúzuláj
fuzzy = fázi
gameplay = geimplei
gangs = gaŋs
gangster = gaŋstur
gaps = gaps
gardens = garduns
gassy = gasi
gathered = gadhurd
gathers = gadhurs
George = Jorj
German = Jurmun
gigantic = jaigantik
giraffe = jiráf
girl's = gurls
girlfriend = gurlfrend
girly = gurli
glee = gly
glimpse = glimps
gloomier = gloúmiur
glow = glou
gobbled = gobuld
golden = gouldun
goodbyes = gúdbais
goodie = gúdi
Goodman = Gúdmun
goodnight = gúdnait
goods = gúds
google's = Gúguls
goreng = goreng
gotta = gotu
government = gávurnmunt
grad = grad
grades = greids
graduate = grajúut
graduated = grajúeitud
graduates = grajúuts
graduating = grajúeitiŋ
grandparent's = grandparunts
graphics = gráfiks
grassy = grási
greatly = greitli
Greece = Grys
greedy = grydi
Greek = Gryk
greeting = grytiŋ
grills = grils
groaned = ground
grok = grok
grotesque = groutesk
grow = grou
growled = grauld
grown = groun
Guangzhou = Gúáŋzhou
guessed = gesd
guessing = gesiŋ
guidance = gaiduns
guides = gaids
gush = gásh
hack = hak
hackathon = hakuthon
hadn't = hadunt
hallways = holweis
halt = holt
ham = ham
hammer = hamur
Han = Hán
handballs = handbols
handing = handiŋ
handlebar = handulbar
handling = handliŋ
hanged = haŋd
hanging = haŋiŋ
hangouts = haŋauts
happen = hapun
happening = hapuniŋ
happily = hapili
hardly = hardli
hardware = hardwer
harshly = harshli
hatchback = hacbak
he'll = hyl
headlines = hedlains
Heartbleed = Hartblyd
heat = hyt
heights = haits
hell = hel
hello'ing = helouiŋ
hemisphere = hemisfiur
hemispherical = hemisfiurikul
heyday = heidei
hide = haid
hierarchy = hairarki
hifi = haifai
highways = haiweis
hiking = haikiŋ
hinduism = hindúizum
hint = hint
hinting = hintiŋ
hip = hip
hiring = haiuriŋ
Hiroshima = Hiroshimá
hiss = his
history = histuri
hobbies = hobis
Hokkien = Hokkien
hold = hould
holders = houldurs
hole = houl
Holland = Hollund
hollow = holou
home's = houms
homeless = houmlus
homes = houms
Honda = Hondá
honest = onust
honours = onurs
hookers = húkurs
hop = hop
hoped = houpd
hopelessly = houplusli
horde = hord
horrified = horifaid
horrifying = horifaiiŋ
horse = hors
horsepower = horspauur
hospitality = hospitaliti
hostage = hostij
Hostco = HoustKou
hostile = hostail
hovered = hávurd
hovering = hávuriŋ
how's = haus
Hoxton = Hokstun
Hoyts = Hoyts
hub = háb
hue = hiú
hued = hiúd
hues = hiús
hum = hám
humanoid = hiúmunoid
humorous = hiúmurus
humour = hiúmur
hunt = hánt
hurdles = hurduls
hurry = huri
ice = ais
icon = aikon
identification = aidentifikeishun
identity = aidentiti
idiot = idiut
idiots = idiuts
idle = aidul
idol = aidul
ignore = ignor
ignores = ignors
ill = il
illegal = ilygul
illuminating = ilúmineitiŋ
illustrating = ilustreitiŋ
imagery = imijri
images = imijus
imaginary = imajinuri
imagine = imajin
imitating = imiteitiŋ
immersion = imurzhun
impatient = impeishunt
impatiently = impeishuntli
impenetrable = impenutrubul
implementations = implumunteishuns
implies = implais
impossible = imposibul
impression = impreshun
impromptu = impromptú
improve = imprúv
include = iŋklúd
increase = iŋkrys
increased = iŋkrysd
increment = iŋkrimunt
incrementing = iŋkrimentiŋ
incubate = iŋkiúbeit
incubator = iŋkiúbeitur
Indians = Indiuns
indicate = indikeit
indigenous = indijinus
Indo = Indou
Indonesia's = Indonesiás
indoors = indors
induction = indákshun
infatuated = infacúeitud
infested = infestud
inflatable = infleitubul
informed = informd
ingredients = ingrydiunts
initials = inishuls
initiated = inishieitud
injury = injuri
insisted = insistud
inspired = inspaiurd
installation = instoleishun
installed = instold
installing = instoliŋ
instant = instunt
instantly = instuntli
instincts = instiŋkts
institution = institiúshun
institutions = institiúshuns
instructed = instráktud
instructs = instrákts
insulted = insáltud
insulting = insáltiŋ
insults = insálts
insurance = inshúruns
intake = inteik
intelligence = intelijuns
intend = intend
intends = intends
intensity = intensiti
interact = interakt
interests = intrusts
interlocking = inturlokiŋ
internships = inturnships
interrogate = interugeit
interrupted = inturáptud
interval = inturvul
intervene = inturvyn
interviews = inturviús
interweaved = inturwyvd
intriguing = intrygiŋ
invest = invest
invested = investud
invisible = invizibul
invites = invaits
inviting = invaitiŋ
involve = involv
involves = involvs
ion = aion
ironically = aironikuli
island = ailund
islander = ailundur
issued = ishúd
it'll = itul
item = aitum
jack = jak
jackbox = jakboks
jacket = jakit
jamo = jámo
jeers = jiurs
Jimmy's = Jimmys
John = John
jokes = jouks
Jon = Jon
journeys = jurnis
joy = joi
joyful = joifúl
judge = jáj
jumping = jámpiŋ
katakana = kátákáná
kebab = kubáb
keeps = kyps
kerosene = kerusyn
key = ky
keyboards = kybourds
keyword = kywurd
kick = kik
kidnapping = kidnapiŋ
killing = kiliŋ
kilometres = kilomiturs
kingpin = kiŋpin
kiosk = kiosk
kissing = kisiŋ
knee = ny
knit = nit
knocked = nokd
Korea's = Kouriás
kozelj = <kozelj>
lacking = lakiŋ
ladies = leidis
lah = láh
lamp = lamp
landed = landud
landing = landiŋ
landscape = landskeip
lanes = leins
lasted = lástud
latest = leitest
laughs = láfs
launching = loonciŋ
lawnmower = loonmouur
layer = leiur
laying = leiiŋ
leaders = lydurs
leap = lyp
learned = lurnd
leash = lysh
lectures = lekcurs
legible = lejibul
length = leŋth
Lenovo = Lenouvou
lesson = lesun
let's = lets
letting = letiŋ
liaison = lieizon
liberal = liburul
library's = laibruris
license = laisuns
lie = lai
lifesize = laifsaiz
lifestyle = laifstail
lighter = laitur
lighters = laiturs
likes = laiks
likewise = laikwaiz
linguistic = liŋgwistik
link = liŋk
LinkedIn = LiŋkdIn
lion = laiun
literally = lituruli
Liverpool = Livurpúl
load = loud
loaded = loudud
loading = loudiŋ
loathed = louthd
lock's = loks
lockers = lokurs
lone = loun
loop = lúp
loss = los
loved = lávd
lovely = lávli
lucky = láki
luggage = lágij
Luke = Loúk
luminance = lúminuns
Madsen = Madsun
maglev = maglev
magnets = magnuts
magnified = magnifaid
mainland = meinland
maintaining = meinteiniŋ
maker = meikur
makes = meiks
Malaysia = Muleisia
manager = manjiur
manages = manijus
manipulating = manipiúleitiŋ
marked = markd
markers = markurs
Mars = Mars
mascot = máskot
mashup = masháp
massage = musáj
massaging = musájiŋ
master = mástur
mate = meit
mates = meits
mathematics = mathumatiks
mattress = matrus
mature = macur
Mcdonald's = Mukdonulds
meager = mygur
meal = myl
mean = myn
means = myns
meantime = myntaim
measures = mezhurs
mechanism = mukenizum
media = midiá
median = midiun
medic = medik
medium = midium
mega = megá
megacity = megásiti
melancholic = melunkolik
melted = meltud
memes = myms
memorable = memurubul
memorised = memuraizd
men = men
menacing = menusiŋ
mentally = mentuli
mercurial = murkiúriul
merely = miurli
merge = murj
metaphor = metáfor
metaphors = metáfors
metres = miturs
Mexico's = Meksikous
microorganisms = maikrouorganizums
microscopes = maikrouskoups
microservices = maikrousurvisus
midst = midst
mild = maild
millennium = milenium
minding = maindiŋ
minibus = minibás
minimalist = minimulist
minority = mainoriti
mint = mint
miscellaneous = misulanius
mischief = miscif
miserable = mizurubul
missed = mist
misses = misus
missing = misiŋ
mistake = misteik
mockingly = mokiŋli
mod = mod
mode = moud
modelling = mouduliŋ
modified = modifaid
modifying = modifaiiŋ
moist = moist
monitoring = monituriŋ
monologue = monolog
monopoly = monopuli
monorail = monorel
monstrosity = monstrositi
moral = morul
morons = mourons
morphed = morfd
mosquitoes = moskytous
motivated = moutiveitud
motorcycle = moutursaikul
motors = mouturs
mountainous = mauntunus
mower = mouur
mud = mád
muesli = miúsli
multicultural = máltikálcurul
multilevel = máltilevel
multipurpose = máltipurpus
multistorey = máltistori
mum's = máms
murderous = murdurus
must've = mástuv
mustering = másturiŋ
mutations = miúteishuns
mute = miút
mysteriously = mistiriusli
mystery = misturi
mythology = mitholuji
nah = náh
nailing = neiliŋ
nanoscience = nanousaiuns
narcotics = narkotiks
narrated = nareitud
nasty = násti
natured = neicurd
navigate = navigeit
nearly = niurli
neat = nyt
neatly = nytli
neighbourhood = neiburhúd
net = net
networked = netwurkd
neutral = niúcrul
newcomer = niúkámur
Nguyen = [Ŋwin, Niúun]
nicest = naisust
Nicholas = Nikulus
nigga = niggá
nightmare = naitmer
nights = naits
Nintendo = Nintendou
noises = noizus
nominate = nomineit
nominated = nomineitud
nonexistent = nonigzistunt
noobs = noúbs
normally = normuli
Norman = Normun
nose = nouz
nosebleed = nouzblyd
noses = nouzus
nostalgic = nostaljik
noted = noutud
noticeable = noutisubul
notices = noutisus
notification = noutifikeishun
notified = noutifaid
notion = noushun
November = Nouvembur
null = nál
numbers = námburs
obligations = obligeishuns
obliged = oblaijd
observations = obzurveishuns
observing = ibzurviŋ
obsessed = obsesd
obstacles = obstikuls
obvious = ovius
occasion = okeizhun
occasionally = okeizunuli
odourless = oudurlus
offering = ofuriŋ
offroad = ofroud
offset = ofset
Olympic = Oulimpik
ominous = ominus
onboard = onbourd
ongoing = ongouiŋ
oozed = oúzd
openings = oupuniŋs
openly = oupunli
opera = oprá
opinion = opiniun
opponents = opounints
opted = optud
optional = opshunul
options = opshuns
ordeal = ordyl
ordering = orduriŋ
orders = ordurs
organised = orgunaizd
oriented = oriuntud
origin = orijin
origins = orijins
ornamental = ornumentul
ornaments = ornumunts
outdoor = autdor
outdoors = autdors
outsider = autsaidur
outsiders = autsaidurs
outspoken = autspoukun
overcome = ouvurkám
overhear = ouvurhiur
overheat = ouvurhyt
overlapped = ouvurlapd
overtaking = ouvurteikiŋ
overwhelmingly = ouvurwelmiŋli
owner = ounur
owners = ounurs
owning = ouniŋ
pace = peis
Pacific = Pusifik
package = pakij
pad = pad
pain = pein
paint = peint
paintbrush = peintbrásh
paired = perd
pan = pan
Panadol = Panudol
pandemic = pandemik
panel = panul
panels = panuls
panic = panik
par = par
parachute = parushút
parallel = parulel
paramedic = parumedik
paranoid = parunoid
parking = parkiŋ
parks = parks
participant = partisipunt
participated = partisipeitud
participating = partisipeitiŋ
participation = partisipeishun
parties = partis
partner = partnur
partners = partnurs
passengers = pasinjurs
passes = pásus
paste = peist
patch = pac
pathology = pátholoji
pathways = páthweis
patiently = peishuntli
patted = patud
paused = poozd
pavement = peivmunt
payments = peimunts
peace = pys
peak = pyk
peaked = pykd
peek = pyk
peer = piur
penetrate = penutreit
penguins = peŋgwins
per = pur
percentage = pursentij
perception = pursepshun
perceptions = pursepshuns
perched = purcd
perfect = purfekt
perform = purform
performances = purformunsus
performing = purformiŋ
period = piriud
permission = purmishun
permitting = purmitiŋ
perpetual = purpecúul
personnel = pursunul
perverted = purvurtud
petrol = petrul
phonetically = fonetikuli
picture = pikcur
piercing = piursiŋ
pig = pig
pillow = pilou
pills = pils
ping = piŋ
pink = piŋk
pins = pins
pipe = paip
pit = pit
pity = piti
pixel = piksul
pixels = piksuls
placement = pleismunt
placing = pleisiŋ
planes = pleins
plunged = plánjd
plus = plás
plush = plásh
policies = polisis
poll = pol
poncho = poncou
pong = poŋ
poo = poú
poop = poúp
poorly = pourli
pork = pork
porno = pornou
portions = porshuns
posh = posh
possession = poseshun
possessions = poseshuns
possibly = posibli
posted = poustud
poster = poustur
postgrad = poustgrad
potential = potenshul
pour = pour
pouring = pouriŋ
poverty = povurti
power = pauur
powerup = pauuráp
practices = praktisus
praise = preiz
precious = preshus
precursor = prikursur
predict = pridikt
predicting = pridiktiŋ
predominantly = pridominuntly
pregnant = pregnunt
prepared = priperd
prescribed = priskraibd
presented = prizentud
presenter = prizentur
presenters = prizenturs
press = pres
pressured = preshurd
presuming = prizhúmiŋ
pretend = pritend
prevented = priventud
princess = prinses
printer = printur
prioritising = praiorutaiziŋ
priority = praioruti
privileges = privilijus
pro = prou
problematic = problumatik
procedures = prosyjurs
proceed = prosyd
processing = prosesiŋ
procrastination = prokrastineishun
producing = prodiúsiŋ
production = prodákshun
products = prodákts
professional = profeshunul
profile = proufail
profits = profits
prominence = prominuns
promising = promisiŋ
prone = proun
properly = propurli
proportions = proporshuns
proved = proúvd
provides = provaids
providing = provaidiŋ
proving = proúviŋ
pub = páb
puff = páf
pull = púl
pulls = púls
punish = pánish
purchased = purcisd
pure = pior
purely = piorli
pursue = purshú
pursuing = purshúiŋ
pursuit = pursoút
push = púsh
pushing = púshiŋ
puts = púts
puzzles = pázuls
quadrangle = kwodraŋgul
quadrangle's = kwodraŋguls
quality = kwoluti
Questacon = Kwestukon
questioned = kwescund
queuing = kiúiŋ
quicker = kwikur
quietest = kwaiutust
quitting = kwitiŋ
radio = reidiou
raffle = raful
raft = ráft
rage = reij
rail = rel
rails = rels
rained = reind
raising = reiziŋ
random = randum
randomly = randumli
rank = raŋk
ranking = raŋkiŋ
rather = rádhur
raw = roo
rays = reis
razor = reizur
reached = rycd
reaches = rycus
reacting = riaktiŋ
reaction = riakshun
realm = relm
rear = riur
rearrange = riureinj
rebuilt = ribilt
received = risyvd
receives = risyvs
reception = risepshun
recess = rises
reckoning = rekuniŋ
reclaim = rikleim
recognized = rekugnaizd
recommend = rekumend
recommendation = rekumendeishun
record = [rekurd, rikord]
recounts = rikaunts
recovered = rikávurd
Reddit = Reddit
redevelopment = ridivelupmunt
reduce = ridiús
reencounter = rienkauntur
reenter = rienter
referred = rifurd
refined = rifaind
reflect = ruflekt
reflections = riflekshuns
refreshing = rifreshiŋ
refreshments = rifreshmunts
regardless = rigardlus
regions = ryjuns
register = rejistur
registered = rejisturd
registering = rejisturiŋ
regret = rigret
regular = regiúlur
reinforces = riinforsus
reinforcing = riinforsiŋ
rejection = rijekshun
rejoice = rijois
rejoined = rijoind
relations = rileishuns
relative's = relutivs
release = rilys
released = rilysd
relieve = rilyv
relieved = rilyvd
religion = rilijun
reluctant = riláktunt
remained = rimeind
remarks = rimarks
reminisced = remunisd
reminiscent = remunisunt
remote = rimout
remove = rimoúv
renamed = rineimd
renting = rentiŋ
repeat = ripyt
repeatable = ripytubul
repeated = ripytud
replacing = ripleisiŋ
replied = riplaid
report = riport
reported = riportud
reporters = riporturs
repository = ripozituri
represent = reprizent
representative' = reprizentutiv
represented = reprizentud
represents = reprizents
reproduced = riprodiúsd
reputation = repiúteishun
request = rikwest
requesting = rikwestiŋ
requirement = rikwaiurmunt
requiring = rikwaiuriŋ
rescue = reskiú
researcher = risurcur
researchers = risurcurs
resemble = rizembul
resorted = rizorted
responding = respondiŋ
responsive = responsiv
resting = restiŋ
restrained = ristreind
restraining = ristreiniŋ
restrict = ristrikt
restricted = ristriktud
retaliation = ritalieishun
retrieve = ritryv
retrieving = ritryviŋ
retro = retrou
reunion = riyúniun
reusable = riyúzubul
revamped = rivampd
reveals = rivyls
revelation = revuleishun
revenue = revuniú
reverses = rivursus
review = riviú
revision = rivizhun
revival = rivaivul
rewarded = riwordud
rickroll = rikroul
rightmost = raitmoust
rise = raiz
risky = riski
roaming = roumiŋ
robustness = roubástnus
rod = rod
rode = roud
rolled = rould
roller = roulur
rolling = rouliŋ
romantically = romantikuli
rome = roum
roof = roúf
rope = roup
rotated = routeitud
rough = ráf
route = rút
routine = rútyn
rover = rouvur
rudely = roúdli
runner = ránur
runs = ráns
runtime = rántaim
rural = rúrul
rushing = ráshiŋ
sadly = sadli
safe = seif
safely = seifli
sand = sand
satisfied = satisfaid
satisfying = satisfaiiŋ
scaling = skeiliŋ
scan = skan
scanning = skaniŋ
scattered = skaturd
scenic = synik
schedule = skejúl
scissors = sizurs
scolds = skoulds
scooping = skoúpiŋ
scooters = skúturs
score = skor
scoreboard = skorbourd
scoring = skoriŋ
scratched = skracd
scream = skrym
screeches = skrycus
screening = skryniŋ
screens = skryns
scrum = skrám
sculptures = skálpcurs
seal = syl
search = surc
seas = sys
seconding = sekundiŋ
seek = syk
selling = seliŋ
sells = sels
semester's = semesturs
send = send
sensor = sensur
separate = sepureit
separately = sepurutli
sequence = sykwuns
seriously = siriusli
serves = survs
services = survisus
servings = surviŋs
session = seshun
sessions = seshuns
sets = sets
settings = setiŋs
settling = setuliŋ
seven = sevun
severely = seviurli
shady = sheidi
shake = sheik
shaking = sheikiŋ
shaky = sheiki
shanty = shanti
shapes = sheips
sharing = sheriŋ
shattering = sháturiŋ
she's = shys
shelf = shelf
shifted = shiftud
shifts = shifts
shine = shain
shining = shainiŋ
shittier = shitiur
shocking = shokiŋ
shook = shúk
shoot = shút
shoots = shúts
shops = shops
shoulder = shouldur
shouted = shautud
shouting = shautiŋ
showcases = shoukeisus
shower = shauur
showers = shauurs
shutters = sháturs
shy = shai
Sichuan = Sichuán
sides = saids
sifting = siftiŋ
sigh = sai
sightseeing = saitsiiŋ
silence = sailuns
silently = sailuntli
similarities = similaritis
similarity = similariti
simplifying = simplifaiiŋ
Simpsons = Simpsuns
simulator = simiúleitur
Singaporeans = Siŋguporiuns
singleton = siŋgultun
sink = siŋk
sinks = siŋks
situated = sicúeitud
skateboards = skeitbourds
skill = skil
skinned = skind
skipped = skipd
skydiving = skaidaiviŋ
slack = slak
slash = slash
Slazenger = Slazinjur
sleek = slyk
sleepover = slypouvur
slightest = slaitust
slimy = slaimi
slipping = slipiŋ
slips = slips
slob = slob
slope = sloup
slot = slot
slowly = slouli
slum = slám
smiles = smails
Smith = Smith
smoke = smouk
smoothly = smoúdhli
snacks = snaks
snaps = snaps
snoozing = snoúziŋ
soaks = souks
soap = soup
socialise = soushulaiz
socialite = soushulait
socially = soushuli
sofa = soufá
softness = softnus
soiled = soild
sojourn = sojurn
sold = sould
solid = solid
solitary = solituri
someone's = sámwáns
somersaulting = sámersooltiŋ
song's = soŋs
songs = soŋs
Sonia = Soniá
sorts = sorts
souls = souls
south = sauth
southern = sádhurn
souvenirs = soúvuniurs
spaghetti = spugeti
spanish = spanish
spanning = spaniŋ
sparse = spars
speaker = spykur
speakers = spykurs
specialise = speshulaiz
specialised = speshulaizd
specific = spusifik
spelling = speliŋ
spill = spil
splashing = splashiŋ
splattered = splaturd
splendour = splendur
spoken = spoukun
sponsored = sponsurd
spontaneous = sponteinius
spring = spriŋ
squatting = skwotiŋ
squishy = skwishi
stages = steijus
stained = steind
staircases = sterkeisus
stank = staŋk
star = star
staring = steriŋ
startled = startuld
startling = startuliŋ
stating = steitiŋ
stationed = steishund
statue = stacoú
status = steitus
steal = styl
steam = stym
steel = styl
stellar = stelur
stepping = stepiŋ
Stewart = Stoúwurt
sticker = stikur
sticking = stikiŋ
sticks = stiks
stink = stiŋk
stint = stint
stock = stok
stopping = stopiŋ
storeroom = stourrúm
stores = stours
stories = storis
storyline = storilain
straightforward = streitforwurd
strain = strein
strains = streins
strand = strand
strangest = streinjust
straws = stroos
streetlamps = strytlamps
strengthen = streŋthun
stroll = stroul
Stuart = Stúurt
stubby = stábi
stumbled = stámbeld
stunning = stániŋ
styles = stails
stylus = stailus
sub = sáb
subarray = sáburei
submissions = sábmishuns
submit = sábmit
submitted = sábmited
substitution = sábstitiúshun
suburb = sáburb
suburbs = sáburbs
succeed = suksyd
sufficient = sáfishunt
sufficiently = sáfishuntli
suffocated = sáfokeitud
sum = sám
summer = sámer
summers = sámers
summoned = sámend
sunlight = sánlait
sunset = sánset
sunshine = sánshain
superior = súpiriur
supermarket = súpurmarkit
superstar = súpurstar
supervisors = súpurvaizurs
supporter = suportur
supports = suports
suppose = supouz
surely = shurli
surface = surfis
surprised = surpraizd
surprising = surpraiziŋ
surprisingly = surpraiziŋli
surround = suraund
suspiciously = sáspishusli
swap = swop
swapped = swopt
sway = swei
swaying = sweiiŋ
swears = swers
sweeping = swypiŋ
swimming = swimiŋ
switched = swicd
swollen = swoulun
swore = swor
sworn = sworn
swung = swáŋ
symbol = simbul
symbolic = simbolik
symbolised = simbulaizd
tablet = tablut
taco = tákou
tags = tags
takes = teiks
talent = talunt
talkie = tooki
tapping = tapiŋ
target = targit
targeted = targitud
tea = ty
teacher = tycur
teaching = tyciŋ
teaming = tymiŋ
tear = [ter, tiur]
tearing = [teriŋ, tiuriŋ]
technical = teknikul
technically = teknikuli
technique' = teknik
teenagers = tyneijurs
teh = teh
template = templut
Teochew = Tiociú
term = turm
terminating = turmineitiŋ
termination = turmineishun
terribly = teribli
terrifying = terifaiiŋ
territory = terituri
terrorist = terurist
Thailand = Thailand
thanked = thaŋkd
thanking = thaŋkiŋ
thats = dhats
theatrical = thiatrikul
themed = thymd
theoretical = thiuretikul
thermos = thermos
thermoses = thermosus
thighs = thais
thingies = thiŋis
Thinkpad = Thiŋkpad
thousands = thauzunds
threaten = thretun
threatening = thretuniŋ
threatens = thretuns
threw = throú
thrilling = thriliŋ
throwed = throud
thrower = throuur
thrown = throun
throws = throus
thru = thrú
thumbnail = thámneil
thumbs = tháms
tied = taid
till = til
Tina = Tiná
tiny = taini
tiptoed = tiptoud
tissue = tishú
titled = taituld
titles = taituls
tomato = tomeitou
tongue = táŋ
toothpaste = túthpeist
tower = tauur
towered = tauurd
toys = tois
traditional = tradishunul
traditionally = tradishunuli
transformed = tránsformd
transition = tránzishun
translation = tránsleishun
translucent = tránslúsunt
transparent = tránsperunt
transporting = tránsportiŋ
trapped = trapd
trays = treis
treated = trytud
treating = trytiŋ
trembled = trembuld
trespass = trespás
trespassing = trespásiŋ
tricked = trikd
tricking = trikiŋ
trio = triou
tripping = tripiŋ
trouble = trábul
truly = troúli
trusted = trástud
tube = tiúb
tucked = tákd
tune = tiún
tunnels = tánuls
twist = twist
typeface = taipfeis
typically = tipikuli
uber = oúbur
ultimately = oltimutli
umm = ámm
unaware = ánuwer
unclean = áŋklyn
unclear = áŋkliur
uncomfortable = áŋkámfurtubul
uncover = áŋkávur
undergrad = ándurgrad
underlying = ándurlaiiŋ
underwater = ándurwotur
underwear = ándurwer
unexpectedly = ánekspektudli
unfamilar = ánfumiliur
unhealthy = ánhelthi
unhygenic = ánhaijynik
unidentified = ánaidentifaid
uninhabited = áninhabitud
union = yúniun
universal = yúnivursul
universally = yúnivursuli
universe = yúnivurs
unlock = ánlok
unlocked = ánlokd
unnatural = ánnacurul
unplanned = ánpland
unpredictable = ánpridiktubul
unrecorded = ánrikordud
unrelated = ánrileitud
unsafe = ánseif
unsealed = ánsyld
unsupported = ánsuportud
unsure = ánshur
untouchable = ántacubul
unwelcome = ánwelkám
updated = ápdeited
uphill = áphil
upside = ápsaid
urban = urbun
urinate = yúrineit
urinating = yúrineitiŋ
username = yúsurneim
usually = yúzhúuli
utilised = yútilaizd
utilises = yútilaizus
utter = átur
vacant = veikunt
vaguely = veigli
valid = valid
validate = valideit
valued = valiúd
vanish = vanish
vanished = vanishd
vastness = vástnus
vegan = vygun
vehicle = viukul
vehicles = viukuls
veil = veil
verandah = vurandáh
Veronica = Veroniká
versa = vursá
vertical = vurtikul
vibes = vaibs
vice = vais
Victorian = Viktoriun
victory = vikturi
viewed = viúd
viewing = viúiŋ
villa = vilá
virgins = vurjins
virus = vairus
visa = visá
visible = vizubul
visiting = vizitiŋ
vivid = vivid
vocabulary = voukabiúluri
vocal = voukul
voted = voutud
voucher = vaucur
vouchers = vaucurs
walkie = wooki
walkway = wookwei
walkways = wookweis
wand = wond
war = wor
warm = worm
warned = wornd
wash = wosh
washed = woshd
waste = weist
waves = weivs
Wayne = Wein
weakly = wykli
weapon = wepun
weaponry = wepunri
wed = wed
weights = weits
weirdest = wiurdust
welcoming = welkámiŋ
west = west
wheeled = wyld
whiteboard = waitbourd
who's = hoús
widely = waidli
wider = waidur
wife = waif
wildlife = waildlaif
willing = wiliŋ
wind = [waind, wind]
windbreaker = windbreikur
wing = wiŋ
winter = wintur
wipe = waip
wiped = waipd
wipes = waips
wire = waiur
witnessed = witnusd
witnesses = witnusus
wolf = wúlf
women's = wimuns
wondered = wándurd
workers = wurkurs
workforce = wurkfors
workshops = wurkshops
worsen = wursun
worsened = wursund
worthy = wurdhi
wouldn't = wúdunt
wow = wau
wrapper = rapur
wristband = ristband
writers = raiturs
writes = raits
written = ritun
yell = yel
yip = yip
you'd = yúd
you'll = yúl
you've = yúv
younger = yáŋgur
youth = yúth
yue = yú
zero = zirou
zigzag = zigzag
Zika = Ziká
zip = zip
zongzi = zoŋzi
applicant = aplikunt
applicants = aplikunts
interviewer = inturviúur
interviewers = inturviúurs
Tracy = Treisy
lobby = lobi
programmer = programur
programmers = programurs
Django = Djáŋgou
Python = Paithun
reviews = riviús
reviewing = riviúiŋ
reviewings = riviúiŋs
reviewed = riviúd
relate = rileit
resolve = rizolv
resolved = rizolvd
clarified = klarifaid
assertive = usurtiv
detect = ditekt
detected = ditektud
documentation = dokiúmunteisiun
documentations = dokiúmunteisiuns
could've = kúduv
adversary = advursuri
adversaries = advursuris
adversarial = advursariul
matters = maturs
mattered = maturd
maps = maps
interface = inturfeis
interfaces = inturfeisus
differences = difrunsus
directly = dairektli
implement = impliment
implements = impliments
define = difain
defines = difains
abstract = abstrakt
abstracts = abstrakts
variable = variubul
variables = variubuls
needs = nyds
function = fáŋshun
functions = fáŋshuns
coordinate = [ko'ordinit, ko'ordineit]
coordinates = ko'ordinits
boolean = búliun
pawn = poon
king = kiŋ
bishop = bishup
currents = kárunts
currently = káruntli
contains = konteins
reflection = riflekshun
reflections = riflekshuns
reflected = riflektud
difficult = difikult
scenario = synáriou
scenarios = synárious
they'll = dheil
option = opshun
Philip = Philip
native = neitiv
natives = neitivs
agile = ajail
contacts = kontakts
contacted = kontaktud
apologised = upolujaizd
apologetic = upolujetik
apology = upoluji
apologies = upolujis
sooner = soúnur
here's = hiurs
sentence = sentuns
tests = tests
values = valiús
etc = ets
extend = ekstend
extends = ekstends
sprint = sprint
sprints = sprints
January = Janiúuri
February = Febiúuri
March = Marc
April = Eiprul
June = Jún
July = Júlai
August = Oogust
September = Septembur
October = Oktoubur
November = Nouvembur
December = Disembur
